*****XX****X********XXXX*****XX****X********XXXX*****XX****X********XXXX*****XX****X********XXXX*****XX****X********XXXX*****XX****X********XXXX*****XX****X********XXXX*****XX****X********XXXX
XX******XX***XXXXX***XXXXX******XX***XXXXX***XXXXX******XX***XXXXX***XXXXX******XX***XXXXX***XXXXX******XX***XXXXX***XXXXX******XX***XXXXX***XXXXX******XX***XXXXX***XXXXX******XX***XXXXX***XXX
XX***XXXX**XXXXX****XXXXXX***XXXX**XXXXX****XXXXXX***XXXX**XXXXX****XXXXXX***XXXX**XXXXX****XXXXXX******XX***XXXXX***XXXXX******XX***XXXXX***XXXXX******XX***XXXXX***XXXXX******XX***XXXXX***XXX
XX***XXXXXXXXXXXXXX****XXX***XXXXXXXXXXXXXX****XXX***XXXXXXXXXXXXXX****XXX***XXXXXXXXXXXXXX****XXX***XXXXXXXXXXXXXX****XXX***XXXXXXXXXXXXXX****XXX***XXXXXXXXXXXXXX****XXX***XXXXXXXXXXXXXX****X
*****XXXXXX****XX***XXXX*****XXXXXX****XX***XXXX*****XXXXXX****XX***XXXX*****XXXXXX****XX***XXXX*****XXXXXX****XX***XXXX*****XXXXXX****XX***XXXX*****XXXXXX****XX***XXXX*****XXXXXX****XX***XXXX
XX*************XXXX*****XX*************XXXX*****XX*************XXXX*****XX*************XXXX*****XX*************XXXX*****XX*************XXXX*****XX*************XXXX*****XX*************XXXX*****
*****XX****X********XXXX*****XX****X********XXXX*****XX****X********XXXX*****XX****X********XXXX*****XX****X********XXXX*****XX****X********XXXX*****XX****X********XXXX*****XX****X********XXXX
XX******XX***XXXXX***XXXXX******XX***XXXXX***XXXXX******XX***XXXXX***XXXXX******XX***XXXXX***XXXXX******XX***XXXXX***XXXXX******XX***XXXXX***XXXXX******XX***XXXXX***XXXXX******XX***XXXXX***XXX
XX***XXXX**XXXXX****XXXXXX***XXXX**XXXXX****XXXXXX***XXXX**XXXXX****XXXXXX***XXXX**XXXXX****XXXXXX***XXXX**XXXXX****XXXXXX***XXXX**XXXXX****XXXXXX***XXXX**XXXXX****XXXXXX***XXXX**XXXXX****XXXX
XX***XXXXXXXXXXXXXX****XXX***XXXXXXXXXXXXXX****XXX***XXXXXXXXXXXXXX****XXX***XXXXXXXXXXXXXX****XXX***XXXXXXXXXXXXXX****XXX***XXXXXXXXXXXXXX****XXX***XXXXXXXXXXXXXX****XXX***XXXXXXXXXXXXXX****X
*****XXXXXX****XX***XXXX*****XXXXXX****XX***XXXX*****XXXXXX****XX***XXXX*****XXXXXX****XX***XXXX*****XXXXXX****XX***XXXX*****XXXXXX****XX***XXXX*****XXXXXX****XX***XXXX*****XXXXXX****XX***XXXX
XX*************XXXX*****XX*************XXXX*****XX*************XXXX*****XX*************XXXX*****XX*************XXXX*****XX*************XXXX*****XX*************XXXX*****XX*************XXXX*****
*****XX****X********XXXX*****XX****X********XXXX*****XX****X********XXXX*****XX****X********XXXX*****XX****X********XXXX*****XX****X********XXXX*****XX****X********XXXX*****XX****X********XXXX
XX******XX***XXXXX***XXXXX******XX***XXXXX***XXXXX******XX***XXXXX***XXXXX******XX***XXXXX***XXXXX******XX***XXXXX***XXXXX******XX***XXXXX***XXXXX******XX***XXXXX***XXXXX******XX***XXXXX***XXX
XX***XXXX**XXXXX****XXXXXX***XXXX**XXXXX****XXXXXX***XXXX**XXXXX****XXXXXX***XXXX**XXXXX****XXXXXX***XXXX**XXXXX****XXXXXX***XXXX**XXXXX****XXXXXX***XXXX**XXXXX****XXXXXX***XXXX**XXXXX****XXXX
XX***XXXXXXXXXXXXXX****XXX***XXXXXXXXXXXXXX****XXX***XXXXXXXXXXXXXX****XXX***XXXXXXXXXXXXXX****XXX***XXXXXXXXXXXXXX****XXX***XXXXXXXXXXXXXX****XXX***XXXXXXXXXXXXXX****XXX***XXXXXXXXXXXXXX****X
*****XXXXXX****XX***XXXX*****XXXXXX****XX***XXXX*****XXXXXX****XX***XXXX*****XXXXXX****XX***XXXX*****XXXXXX****XX***XXXX*****XXXXXX****XX***XXXX*****XXXXXX****XX***XXXX*****XXXXXX****XX***XXXX
XX*************XXXX*****XX*************XXXX*****XX*************XXXX*****XX*************XXXX*****XX*************XXXX*****XX*************XXXX*****XX*************XXXX*****XX*************XXXX*****
*****XX****X********XXXX*****XX****X********XXXX*****XX****X********XXXX*****XX****X********XXXX*****XX****X********XXXX*****XX****X********XXXX*****XX****X********XXXX*****XX****X********XXXX
XX******XX***XXXXX***XXXXX******XX***XXXXX***XXXXX******XX***XXXXX***XXXXX******XX***XXXXX***XXXXX******XX***XXXXX***XXXXX******XX***XXXXX***XXXXX******XX***XXXXX***XXXXX******XX***XXXXX***XXX
XX***XXXX**XXXXX****XXXXXX***XXXX**XXXXX****XXXXXX***XXXX**XXXXX****XXXXXX***XXXX**XXXXX****XXXXXX******XX***XXXXX***XXXXX******XX***XXXXX***XXXXX******XX***XXXXX***XXXXX******XX***XXXXX***XXX
XX***XXXXXXXXXXXXXX****XXX***XXXXXXXXXXXXXX****XXX***XXXXXXXXXXXXXX****XXX***XXXXXXXXXXXXXX****XXX******XX***XXXXX***XXXXX******XX***XXXXX***XXXXX******XX***XXXXX***XXXXX******XX***XXXXX***XXX
*****XXXXXX****XX***XXXX*****XXXXXX****XX***XXXX*****XXXXXX****XX***XXXX*****XXXXXX****XX***XXXXXX******XX***XXXXX***XXXXX******XX***XXXXX***XXXXX******XX***XXXXX***XXXXX******XX***XXXXX***XXX
XX*************XXXX******X*************XXXX******X*************XXXX*****XX*************XXXX*****XX*************XXXX******X*************XXXX******X*************XXXX*****XX*************XXXX*****
*****XX****X********XXXX*****XX****X********XXXX*****XX****X********XXXX*****XX****X********XXXXXX*************XXXX******X*************XXXX******X*************XXXX*****XX*************XXXX*****
XX******XX***XXXXX***XXXXX******XX***XXXXX***XXXXX******XX***XXXXX***XXXXX******XX***XXXXX***XXXXX*************XXXX******X*************XXXX******X*************XXXX*****XX*************XXXX*****
XX***XXXX**XXXXX****XXXXXX***XXXX**XXXXX****XXXXXX***XXXX**XXXXX****XXXXXX***XXXX**XXXXX****XXXXXX*************XXXX******X*************XXXX******X*************XXXX*****XX*************XXXX*****
XX***XXXXXXXXXXXXXX****XXX***XXXXXXXXXXXXXX****XXX***XXXXXXXXXXXXXX****XXX***XXXXXXXXXXXXXX****XXX*************XXXX******X*************XXXX******X*************XXXX*****XX*************XXXX*****
*****XXXXXX****XX***XXXX*****XXXXXX****XX***XXXX*****XXXXXX****XX***XXXX*****XXXXXX****XX***XXXX*****XXXXXX****XX***XXXX*****XXXXXX****XX***XXXX*****XXXXXX****XX***XXXX*****XXXXXX****XX***XXXX
XX*************XXXX*****XX*************XXXX*****XX*************XXXX*****XX*************XXXX*****XX******XX***XXXXX***XXXXX******XX***XXXXX***XXXXX******XX***XXXXX***XXXXX******XX***XXXXX***XXX
*****XX****X********XXXX*****XX****X********XXXX*****XX****X********XXXX*****XX****X********XXXX*****XXXXXX****XX***XXXX*****XXXXXX****XX***XXXX*****XXXXXX****XX***XXXX*****XXXXXX****XX***XXXX
XX******XX***XXXXX***XXXXX******XX***XXXXX***XXXXX******XX***XXXXX***XXXXX******XX***XXXXX***XXXXX******XX***XXXXX***XXXXX******XX***XXXXX***XXXXX******XX***XXXXX***XXXXX******XX***XXXXX***XXX
XX***XXXX**XXXXX****XXXXXX***XXXX**XXXXX****XXXXXX***XXXX**XXXXX****XXXXXX***XXXX**XXXXX****XXXX*****XXXXXX****XX***XXXX*****XXXXXX****XX***XXXX*****XXXXXX****XX***XXXX*****XXXXXX****XX***XXXX
XX***XXXXXXXXXXXXXX****XXX***XXXXXXXXXXXXXX****XXX***XXXXXXXXXXXXXX****XXX***XXXXXXXXXXXXXX****X*****XXXXXX****XX***XXXX*****XXXXXX****XX***XXXX*****XXXXXX****XX***XXXX*****XXXXXX****XX***XXXX
*****XXXXXX****XX***XXXX*****XXXXXX****XX***XXXX*****XXXXXX****XX***XXX******XXXXXX*********XXXXXX******XX***XXXXX***XXXXX******XX***XXXXX***XXXXX******XX***XXXXX***XXXXX******XX***XXXXX***XXX
XX*************XXXX*****XX*************XXXX*****XX*************XXXX*****XX*************XXXX*****XX******XX***XXXXX***XXXXX******XX***XXXXX***XXXXX******XX***XXXXX***XXXXX******XX***XXXXX***XXX
**XX****X********XXXX******X****X********XXXX*****XX****X********XXXX*****XX****X********XXXX*****XX****X********XXXX*****XX****X********XXXX*****XX****X********XXXX*****XX****X***********XXXX
XX******XX***XXXXX***XXXXX******XX***XXXXX***XXXXX******XX***XXXXX***XXXXX******XX***XXXXX***XXXXX******XX***XXXXX***XXXXX******XX***XXXXX***XXXXX******XX***XXXXX***XXXXX******XX***XXXXX***XXX
XX***XXXX**XXXXX****XXXXXX***XXXX**XXXXX****XXXXXX***XXXX**XXXXX****XXXXXX***XXXX**XXXXX****XXXXXX******XX***XXXXX***XXXXX******XX***XXXXX***XXXXX******XX***XXXXX***XXXXX******XX***XXXXX***XXX
XX***XXXXXXXXXXXXXX****XXX***XXXXXXXXXXXXXX****XXX***XXXXXXXXXXXXXX****XXX***XXXXXXXXXXXXXX****XXX***XXXXXXXXXXXXXX****XXX***XXXXXXXXXXXXXX****XXX***XXXXXXXXXXXXXX****XXX***XXXXXXXXXXXXXX****X
*****XXXXXX****XX***XXXX*****XXXXXX****XX***XXXX*****XXXXXX****XX***XXXX*****XXXXXX****XX***XXXX*****XXXXXX****XX***XXXX*****XXXXXX****XX***XXXX*****XXXXXX****XX***XXXX*****XXXXXX****XX***XXXX
XX*************XXXX*****XX*************XXXX*****XX*************XXXX*****XX*************XXXX*****XX*************XXXX*****XX*************XXXX*****XX*************XXXX*****XX*************XXXX*****
*****XX****X********XXXX*****XX****X********XXXX*****XX****X********XXXX*****XX****X********XXXX*****XX****X********XXXX*****XX****X********XXXX*****XX****X********XXXX*****XX****X********XXXX
XX******XX***XXXXX***XXXXX******XX***XXXXX***XXXXX******XX***XXXXX***XXXXX******XX***XXXXX***XXXXX******XX***XXXXX***XXXXX******XX***XXXXX***XXXXX******XX***XXXXX***XXXXX******XX***XXXXX***XXX
XX***XXXX**XXXXX****XXXXXX***XXXX**XXXXX****XXXXXX***XXXX**XXXXX****XXXXXX***XXXX**XXXXX****XXXXXX***XXXX**XXXXX****XXXXXX***XXXX**XXXXX****XXXXXX***XXXX**XXXXX****XXXXXX***XXXX**XXXXX****XXXX
XX***XXXXXXXXXXXXXX****XXX***XXXXXXXXXXXXXX****XXX***XXXXXXXXXXXXXX****XXX***XXXXXXXXXXXXXX****XXX***XXXXXXXXXXXXXX****XXX***XXXXXXXXXXXXXX****XXX***XXXXXXXXXXXXXX****XXX***XXXXXXXXXXXXXX****X
*****XXXXXX****XX***XXXX*****XXXXXX****XX***XXXX*****XXXXXX****XX***XXXX*****XXXXXX****XX***XXXX*****XXXXXX****XX***XXXX*****XXXXXX****XX***XXXX*****XXXXXX****XX***XXXX*****XXXXXX****XX***XXXX
XX*************XXXX*****XX*************XXXX*****XX*************XXXX*****XX*************XXXX*****XX*************XXXX*****XX*************XXXX*****XX*************XXXX*****XX*************XXXX*****
*****XX****X********XXXX*****XX****X********XXXX*****XX****X********XXXX*****XX****X********XXXX*****XX****X********XXXX*****XX****X********XXXX*****XX****X********XXXX*****XX****X********XXXX
XX******XX***XXXXX***XXXXX******XX***XXXXX***XXXXX******XX***XXXXX***XXXXX******XX***XXXXX***XXXXX******XX***XXXXX***XXXXX******XX***XXXXX***XXXXX******XX***XXXXX***XXXXX******XX***XXXXX***XXX
XX***XXXX**XXXXX****XXXXXX***XXXX**XXXXX****XXXXXX***XXXX**XXXXX****XXXXXX***XXXX**XXXXX****XXXXXX***XXXX**XXXXX****XXXXXX***XXXX**XXXXX****XXXXXX***XXXX**XXXXX****XXXXXX***XXXX**XXXXX****XXXX
XX***XXXXXXXXXXXXXX****XXX***XXXXXXXXXXXXXX****XXX***XXXXXXXXXXXXXX****XXX***XXXXXXXXXXXXXX****XXX***XXXXXXXXXXXXXX****XXX***XXXXXXXXXXXXXX****XXX***XXXXXXXXXXXXXX****XXX***XXXXXXXXXXXXXX****X
*****XXXXXX****XX***XXXX*****XXXXXX****XX***XXXX*****XXXXXX****XX***XXXX*****XXXXXX****XX***XXXX*****XXXXXX****XX***XXXX*****XXXXXX****XX***XXXX*****XXXXXX****XX***XXXX*****XXXXXX****XX***XXXX
XX*************XXXX*****XX*************XXXX******X*************XXXX******X*************XXXX*****XX*************XXXX*****XX*************XXXX*****XX*************XXXX*****XX*************XXXX*****
*****XX****X********XXXX*****XX****X********XXXX*****XX****X********XXXX*****XX****X********XXXX*****XX****X********XXXX*****XX****X********XXXX*****XX****X********XXXX*****XX****X********XXXX
XX******XX***XXXXX***XXXXX******XX***XXXXX***XXXXX******XX***XXXXX***XXXXX******XX***XXXXX***XXXXX******XX***XXXXX***XXXXX******XX***XXXXX***XXXXX******XX***XXXXX***XXXXX******XX***XXXXX***XXX
XX***XXXX**XXXXX****XXXXXX***XXXX**XXXXX****XXXXXX***XXXX**XXXXX****XXXXXX***XXXX**XXXXX****XXXXXX******XX***XXXXX***XXXXX******XX***XXXXX***XXXXX******XX***XXXXX***XXXXX******XX***XXXXX***XXX
XX***XXXXXXXXXXXXXX****XXX***XXXXXXXXXXXXXX****XXX***XXXXXXXXXXXXXX****XXX***XXXXXXXXXXXXXX****XXX******XX***XXXXX***XXXXX******XX***XXXXX***XXXXX******XX***XXXXX***XXXXX******XX***XXXXX***XXX
*****XXXXXX****XX***XXXX*****XXXXXX****XX***XXXX*****XXXXXX****XX***XXXX*****XXXXXX****XX***XXXXXX******XX***XXXXX***XXXXX******XX***XXXXX***XXXXX******XX***XXXXX***XXXXX******XX***XXXXX***XXX
XX*************XXXX******X*************XXXX******X*************XXXX*****XX*************XXXX*****XX*************XXXX******X*************XXXX******X*************XXXX*****XX*************XXXX*****
*****XX****X********XXXX*****XX****X********XXXX*****XX****X********XXXX*****XX****X********XXXXXX*************XXXX******X*************XXXX******X*************XXXX*****XX*************XXXX*****
XX******XX***XXXXX***XXXXX******XX***XXXXX***XXXXX******XX***XXXXX***XXXXX******XX***XXXXX***XXXXX*************XXXX******X*************XXXX******X*************XXXX*****XX*************XXXX*****
XX***XXXX**XXXXX****XXXXXX***XXXX**XXXXX****XXXXXX***XXXX**XXXXX****XXXXXX***XXXX**XXXXX****XXXXXX*************XXXX******X*************XXXX******X*************XXXX*****XX*************XXXX*****
XX***XXXXXXXXXXXXXX****XXX***XXXXXXXXXXXXXX****XXX***XXXXXXXXXXXXXX****XXX***XXXXXXXXXXXXXX****XXX*************XXXX******X*************XXXX******X*************XXXX*****XX*************XXXX*****
*****XXXXXX****XX***XXXX*****XXXXXX****XX***XXXX*****XXXXXX****XX***XXXX*****XXXXXX****XX***XXXX*****XXXXXX****XX***XXXX*****XXXXXX****XX***XXXX*****XXXXXX****XX***XXXX*****XXXXXX****XX***XXXX
XX*************XXXX*****XX*************XXXX*****XX*************XXXX*****XX*************XXXX*****XX******XX***XXXXX***XXXXX******XX***XXXXX***XXXXX******XX***XXXXX***XXXXX******XX***XXXXX***XXX
*****XX****X********XXXX*****XX****X********XXXX*****XX****X********XXXX*****XX****X********XXXX*****XXXXXX****XX***XXXX*****XXXXXX****XX***XXXX*****XXXXXX****XX***XXXX*****XXXXXX****XX***XXXX
XX******XX***XXXXX***XXXXX******XX***XXXXX***XXXXX******XX***XXXXX***XXXXX******XX***XXXXX***XXXXX******XX***XXXXX***XXXXX******XX***XXXXX***XXXXX******XX***XXXXX***XXXXX******XX***XXXXX***XXX
XX***XXXX**XXXXX****XXXXXX***XXXX**XXXXX****XXXXXX***XXXX**XXXXX****XXXXXX***XXXX**XXXXX****XXXX*****XXXXXX****XX***XXXX*****XXXXXX****XX***XXXX*****XXXXXX****XX***XXXX*****XXXXXX****XX***XXXX
XX***XXXXXXXXXXXXXX****XXX***XXXXXXXXXXXXXX****XXX***XXXXXXXXXXXXXX****XXX***XXXXXXXXXXXXXX****X*****XXXXXX****XX***XXXX*****XXXXXX****XX***XXXX*****XXXXXX****XX***XXXX*****XXXXXX****XX***XXXX
*****XXXXXX****XX***XXXX*****XXXXXX****XX***XXXX*****XXXXXX****XX***XXX******XXXXXX*********XXXXXX******XX***XXXXX***XXXXX******XX***XXXXX***XXXXX******XX***XXXXX***XXXXX******XX***XXXXX***XXX
XX*************XXXX*****XX*************XXXX*****XX*************XXXX*****XX*************XXXX*****XX******XX***XXXXX***XXXXX******XX***XXXXX***XXXXX******XX***XXXXX***XXXXX******XX***XXXXX***XXX
*****XX****X********XXXX*****XX****X********XXXX*****XX****X********XXXX*****XX****X********XXXX*****XX****X********XXXX*****XX****X********XXXX*****XX****X********XXXX*****XX****X********XXXX
XX******XX***XXXXX***XXXXX******XX***XXXXX***XXXXX******XX***XXXXX***XXXXX******XX***XXXXX***XXXXX******XX***XXXXX***XXXXX******XX***XXXXX***XXXXX******XX***XXXXX***XXXXX******XX***XXXXX***XXX
XX***XXXX**XXXXX****XXXXXX***XXXX**XXXXX****XXXXXX***XXXX**XXXXX****XXXXXX***XXXX**XXXXX****XXXXXX******XX***XXXXX***XXXXX******XX***XXXXX***XXXXX******XX***XXXXX***XXXXX******XX***XXXXX***XXX
XX***XXXXXXXXXXXXXX****XXX***XXXXXXXXXXXXXX****XXX***XXXXXXXXXXXXXX****XXX***XXXXXXXXXXXXXX****XXX***XXXXXXXXXXXXXX****XXX***XXXXXXXXXXXXXX****XXX***XXXXXXXXXXXXXX****XXX***XXXXXXXXXXXXXX****X
*****XXXXXX****XX***XXXX*****XXXXXX****XX***XXXX*****XXXXXX****XX***XXXX*****XXXXXX****XX***XXXX*****XXXXXX****XX***XXXX*****XXXXXX****XX***XXXX*****XXXXXX****XX***XXXX*****XXXXXX****XX***XXXX
XX*************XXXX*****XX*************XXXX*****XX*************XXXX*****XX*************XXXX*****XX*************XXXX*****XX*************XXXX*****XX*************XXXX*****XX*************XXXX*****
*****XX****X********XXXX*****XX****X********XXXX*****XX****X********XXXX*****XX****X********XXXX*****XX****X********XXXX*****XX****X********XXXX*****XX****X********XXXX*****XX****X********XXXX
XX******XX***XXXXX***XXXXX******XX***XXXXX***XXXXX******XX***XXXXX***XXXXX******XX***XXXXX***XXXXX******XX***XXXXX***XXXXX******XX***XXXXX***XXXXX******XX***XXXXX***XXXXX******XX***XXXXX***XXX
XX***XXXX**XXXXX****XXXXXX***XXXX**XXXXX****XXXXXX***XXXX**XXXXX****XXXXXX***XXXX**XXXXX****XXXXXX***XXXX**XXXXX****XXXXXX***XXXX**XXXXX****XXXXXX***XXXX**XXXXX****XXXXXX***XXXX**XXXXX****XXXX
XX***XXXXXXXXXXXXXX****XXX***XXXXXXXXXXXXXX****XXX***XXXXXXXXXXXXXX****XXX***XXXXXXXXXXXXXX****XXX***XXXXXXXXXXXXXX****XXX***XXXXXXXXXXXXXX****XXX***XXXXXXXXXXXXXX****XXX***XXXXXXXXXXXXXX****X
*****XXXXXX****XX***XXXX*****XXXXXX****XX***XXXX*****XXXXXX****XX***XXXX*****XXXXXX****XX***XXXX*****XXXXXX****XX***XXXX*****XXXXXX****XX***XXXX*****XXXXXX****XX***XXXX*****XXXXXX****XX***XXXX
XX*************XXXX*****XX*************XXXX*****XX*************XXXX*****XX*************XXXX*****XX*************XXXX*****XX*************XXXX*****XX*************XXXX*****XX*************XXXX*****
*****XX****X********XXXX*****XX****X********XXXX*****XX****X********XXXX*****XX****X********XXXX*****XX****X********XXXX*****XX****X********XXXX*****XX****X********XXXX*****XX****X********XXXX
XX******XX***XXXXX***XXXXX******XX***XXXXX***XXXXX******XX***XXXXX***XXXXX******XX***XXXXX***XXXXX******XX***XXXXX***XXXXX******XX***XXXXX***XXXXX******XX***XXXXX***XXXXX******XX***XXXXX***XXX
XX***XXXX**XXXXX****XXXXXX***XXXX**XXXXX****XXXXXX***XXXX**XXXXX****XXXXXX***XXXX**XXXXX****XXXXXX***XXXX**XXXXX****XXXXXX***XXXX**XXXXX****XXXXXX***XXXX**XXXXX****XXXXXX***XXXX**XXXXX****XXXX
XX***XXXXXXXXXXXXXX****XXX***XXXXXXXXXXXXXX****XXX***XXXXXXXXXXXXXX****XXX***XXXXXXXXXXXXXX****XXX***XXXXXXXXXXXXXX****XXX***XXXXXXXXXXXXXX****XXX***XXXXXXXXXXXXXX****XXX***XXXXXXXXXXXXXX****X
*****XXXXXX****XX***XXXX*****XXXXXX****XX***XXXX*****XXXXXX****XX***XXXX*****XXXXXX****XX***XXXX*****XXXXXX****XX***XXXX*****XXXXXX****XX***XXXX*****XXXXXX****XX***XXXX*****XXXXXX****XX***XXXX
XX*************XXXX*****XX*************XXXX*****XX*************XXXX*****XX*************XXXX*****XX*************XXXX*****XX*************XXXX*****XX*************XXXX*****XX*************XXXX*****
*****XX****X********XXXX*****XX****X********XXXX*****XX****X********XXXX*****XX****X********XXXX*****XX****X********XXXX*****XX****X********XXXX*****XX****X********XXXX*****XX****X********XXXX
XX******XX***XXXXX***XXXXX******XX***XXXXX***XXXXX******XX***XXXXX***XXXXX******XX***XXXXX***XXXXX******XX***XXXXX***XXXXX******XX***XXXXX***XXXXX******XX***XXXXX***XXXXX******XX***XXXXX***XXX
XX***XXXX**XXXXX****XXXXXX***XXXX**XXXXX****XXXXXX***XXXX**XXXXX****XXXXXX***XXXX**XXXXX****XXXXXX******XX***XXXXX***XXXXX******XX***XXXXX***XXXXX******XX***XXXXX***XXXXX******XX***XXXXX***XXX
XX***XXXXXXXXXXXXXX****XXX***XXXXXXXXXXXXXX****XXX***XXXXXXXXXXXXXX****XXX***XXXXXXXXXXXXXX****XXX******XX***XXXXX***XXXXX******XX***XXXXX***XXXXX******XX***XXXXX***XXXXX******XX***XXXXX***XXX
*****XXXXXX****XX***XXXX*****XXXXXX****XX***XXXX*****XXXXXX****XX***XXXX*****XXXXXX****XX***XXXXXX******XX***XXXXX***XXXXX******XX***XXXXX***XXXXX******XX***XXXXX***XXXXX******XX***XXXXX***XXX
XX*************XXXX******X*************XXXX******X*************XXXX*****XX*************XXXX*****XX*************XXXX******X*************XXXX******X*************XXXX*****XX*************XXXX*****
*****XX****X********XXXX*****XX****X********XXXX*****XX****X********XXXX*****XX****X********XXXXXX*************XXXX******X*************XXXX******X*************XXXX*****XX*************XXXX*****
XX******XX***XXXXX***XXXXX******XX***XXXXX***XXXXX******XX***XXXXX***XXXXX******XX***XXXXX***XXXXX*************XXXX******X*************XXXX******X*************XXXX*****XX*************XXXX*****
XX***XXXX**XXXXX****XXXXXX***XXXX**XXXXX****XXXXXX***XXXX**XXXXX****XXXXXX***XXXX**XXXXX****XXXXXX*************XXXX******X*************XXXX******X*************XXXX*****XX*************XXXX*****
XX***XXXXXXXXXXXXXX****XXX***XXXXXXXXXXXXXX****XXX***XXXXXXXXXXXXXX****XXX***XXXXXXXXXXXXXX****XXX*************XXXX******X*************XXXX******X*************XXXX*****XX*************XXXX*****
*****XXXXXX****XX***XXXX*****XXXXXX****XX***XXXX*****XXXXXX****XX***XXXX*****XXXXXX****XX***XXXX*****XXXXXX****XX***XXXX*****XXXXXX****XX***XXXX*****XXXXXX****XX***XXXX*****XXXXXX****XX***XXXX
XX*************XXXX*****XX*************XXXX*****XX*************XXXX*****XX*************XXXX*****XX******XX***XXXXX***XXXXX******XX***XXXXX***XXXXX******XX***XXXXX***XXXXX******XX***XXXXX***XXX
*****XX****X********XXXX*****XX****X********XXXX*****XX****X********XXXX*****XX****X********XXXX*****XXXXXX****XX***XXXX*****XXXXXX****XX***XXXX*****XXXXXX****XX***XXXX*****XXXXXX****XX***XXXX
XX******XX***XXXXX***XXXXX******XX***XXXXX***XXXXX******XX***XXXXX***XXXXX******XX***XXXXX***XXXXX******XX***XXXXX***XXXXX******XX***XXXXX***XXXXX******XX***XXXXX***XXXXX******XX***XXXXX***XXX
XX***XXXX**XXXXX****XXXXXX***XXXX**XXXXX****XXXXXX***XXXX**XXXXX****XXXXXX***XXXX**XXXXX****XXXX*****XXXXXX****XX***XXXX*****XXXXXX****XX***XXXX*****XXXXXX****XX***XXXX*****XXXXXX****XX***XXXX
XX***XXXXXXXXXXXXXX****XXX***XXXXXXXXXXXXXX****XXX***XXXXXXXXXXXXXX****XXX***XXXXXXXXXXXXXX****X*****XXXXXX****XX***XXXX*****XXXXXX****XX***XXXX*****XXXXXX****XX***XXXX*****XXXXXX****XX***XXXX
*****XXXXXX****XX***XXXX*****XXXXXX****XX***XXXX*****XXXXXX****XX***XXX******XXXXXX*********XXXXXX******XX***XXXXX***XXXXX******XX***XXXXX***XXXXX******XX***XXXXX***XXXXX******XX***XXXXX***XXX
XX*************XXXX*****XX*************XXXX*****XX*************XXXX*****XX*************XXXX*****XX******XX***XXXXX***XXXXX******XX***XXXXX*****XXX******XX***XXXXX***XXXXX******XX***XXXXX***XXX
***X****X********XXXX*****XX****X********XXXX*****XX****X********XXXX*****XX****X********XXXX*****XX****X********XXXX*****XX****X********XXXX******X****X********XXXX*****XX****X***********XXXX
XX******XX***XXXXX***XXXXX******XX***XXXXX***XXXXX******XX***XXXXX***XXXXX******XX***XXXXX***XXXXX******XX***XXXXX***XXXXX******XX***XXXXX***XXXXX******XX***XXXXX***XXXXX******XX***XXXXX***XXX
XX***XXXX**XXXXX****XXXXXX***XXXX**XXXXX****XXXXXX***XXXX**XXXXX****XXXXXX***XXXX**XXXXX****XXXXXX******XX***XXXXX***XXXXX******XX***XXXXX***XXXXX******XX***XXXXX***XXXXX******XX***XXXXX***XXX
XX***XXXXXXXXXXXXXX****XXX***XXXXXXXXXXXXXX****XXX***XXXXXXXXXXXXXX****XXX***XXXXXXXXXXXXXX****XXX***XXXXXXXXXXXXXX****XXX***XXXXXXXXXXXXXX****XXX***XXXXXXXXXXXXXX****XXX***XXXXXXXXXXXXXX****X
*****XXXXXX****XX***XXXX*****XXXXXX****XX***XXXX*****XXXXXX****XX***XXXX*****XXXXXX****XX***XXXX*****XXXXXX****XX***XXXX*****XXXXXX****XX***XXXX*****XXXXXX****XX***XXXX*****XXXXXX****XX***XXXX
XX*************XXXX*****XX*************XXXX*****XX*************XXXX*****XX*************XXXX*****XX*************XXXX*****XX*************XXXX*****XX*************XXXX*****XX*************XXXX*****
*****XX****X********XXXX*****XX****X********XXXX*****XX****X********XXXX*****XX****X********XXXX*****XX****X********XXXX*****XX****X********XXXX*****XX****X********XXXX*****XX****X********XXXX
XX******XX***XXXXX***XXXXX******XX***XXXXX***XXXXX******XX***XXXXX***XXXXX******XX***XXXXX***XXXXX******XX***XXXXX***XXXXX******XX***XXXXX***XXXXX******XX***XXXXX***XXXXX******XX***XXXXX***XXX
XX***XXXX**XXXXX****XXXXXX***XXXX**XXXXX****XXXXXX***XXXX**XXXXX****XXXXXX***XXXX**XXXXX****XXXXXX***XXXX**XXXXX****XXXXXX***XXXX**XXXXX****XXXXXX***XXXX**XXXXX****XXXXXX***XXXX**XXXXX****XXXX
XX***XXXXXXXXXXXXXX****XXX***XXXXXXXXXXXXXX****XXX***XXXXXXXXXXXXXX****XXX***XXXXXXXXXXXXXX****XXX***XXXXXXXXXXXXXX****XXX***XXXXXXXXXXXXXX****XXX***XXXXXXXXXXXXXX****XXX***XXXXXXXXXXXXXX****X
*****XXXXXX****XX***XXXX*****XXXXXX****XX***XXXX*****XXXXXX****XX***XXXX*****XXXXXX****XX***XXXX*****XXXXXX****XX***XXXX*****XXXXXX****XX***XXXX*****XXXXXX****XX***XXXX*****XXXXXX****XX***XXXX
XX*************XXXX*****XX*************XXXX*****XX*************XXXX*****XX*************XXXX*****XX*************XXXX*****XX*************XXXX*****XX*************XXXX*****XX*************XXXX*****
*****XX****X********XXXX*****XX****X********XXXX*****XX****X********XXXX*****XX****X********XXXX*****XX****X********XXXX*****XX****X********XXXX*****XX****X********XXXX*****XX****X********XXXX
XX******XX***XXXXX***XXXXX******XX***XXXXX***XXXXX******XX***XXXXX***XXXXX******XX***XXXXX***XXXXX******XX***XXXXX***XXXXX******XX***XXXXX***XXXXX******XX***XXXXX***XXXXX******XX***XXXXX***XXX
XX***XXXX**XXXXX****XXXXXX***XXXX**XXXXX****XXXXXX***XXXX**XXXXX****XXXXXX***XXXX**XXXXX****XXXXXX***XXXX**XXXXX****XXXXXX***XXXX**XXXXX****XXXXXX***XXXX**XXXXX****XXXXXX***XXXX**XXXXX****XXXX
XX***XXXXXXXXXXXXXX****XXX***XXXXXXXXXXXXXX****XXX***XXXXXXXXXXXXXX****XXX***XXXXXXXXXXXXXX****XXX***XXXXXXXXXXXXXX****XXX***XXXXXXXXXXXXXX****XXX***XXXXXXXXXXXXXX****XXX***XXXXXXXXXXXXXX****X
*****XXXXXX****XX***XXXX*****XXXXXX****XX***XXXX*****XXXXXX****XX***XXXX*****XXXXXX****XX***XXXX*****XXXXXX****XX***XXXX*****XXXXXX****XX***XXXX*****XXXXXX****XX***XXXX*****XXXXXX****XX***XXXX
XX*************XXXX*****XX*************XXXX*****XX*************XXXX*****XX*************XXXX*****XX*************XXXX*****XX*************XXXX*****XX*************XXXX*****XX*************XXXX*****
*****XX****X********XXXX*****XX****X********XXXX*****XX****X********XXXX*****XX****X********XXXX*****XX****X********XXXX*****XX****X********XXXX*****XX****X********XXXX*****XX****X********XXXX
XX******XX***XXXXX***XXXXX******XX***XXXXX***XXXXX******XX***XXXXX***XXXXX******XX***XXXXX***XXXXX******XX***XXXXX***XXXXX******XX***XXXXX***XXXXX******XX***XXXXX***XXXXX******XX***XXXXX***XXX
XX***XXXX**XXXXX****XXXXXX***XXXX**XXXXX****XXXXXX***XXXX**XXXXX****XXXXXX***XXXX**XXXXX****XXXXXX******XX***XXXXX***XXXXX******XX***XXXXX***XXXXX******XX***XXXXX***XXXXX******XX***XXXXX***XXX
XX***XXXXXXXXXXXXXX****XXX***XXXXXXXXXXXXXX****XXX***XXXXXXXXXXXXXX****XXX***XXXXXXXXXXXXXX****XXX******XX***XXXXX***XXXXX******XX***XXXXX***XXXXX******XX***XXXXX***XXXXX******XX***XXXXX***XXX
*****XXXXXX****XX***XXXX*****XXXXXX****XX***XXXX*****XXXXXX****XX***XXXX*****XXXXXX****XX***XXXXXX******XX***XXXXX***XXXXX******XX***XXXXX***XXXXX******XX***XXXXX***XXXXX******XX***XXXXX***XXX
XX*************XXXX******X*************XXXX******X*************XXXX*****XX*************XXXX*****XX*************XXXX******X*************XXXX******X*************XXXX*****XX*************XXXX*****
*****XX****X********XXXX*****XX****X********XXXX*****XX****X********XXXX*****XX****X********XXXXXX*************XXXX******X*************XXXX******X*************XXXX*****XX*************XXXX*****
XX******XX***XXXXX***XXXXX******XX***XXXXX***XXXXX******XX***XXXXX***XXXXX******XX***XXXXX***XXXXX*************XXXX******X*************XXXX******X*************XXXX*****XX*************XXXX*****
XX***XXXX**XXXXX****XXXXXX***XXXX**XXXXX****XXXXXX***XXXX**XXXXX****XXXXXX***XXXX**XXXXX****XXXXXX*************XXXX******X*************XXXX******X*************XXXX*****XX*************XXXX*****
XX***XXXXXXXXXXXXXX****XXX***XXXXXXXXXXXXXX****XXX***XXXXXXXXXXXXXX****XXX***XXXXXXXXXXXXXX****XXX*************XXXX******X*************XXXX********************XXXX******X*************XXXX*****
*****XXXXXX****XX***XXXX*****XXXXXX****XX***XXXX*****XXXXXX****XX***XXXX*****XXXXXX****XX***XXXX*****XXXXXX*********XXXX*****XXXXXX*********XXXX*****XXXXXX*********XXXX*****XXXXXX*********XXXX
XX*************XXXX*****XX*************XXXX******X*************XXXX******X*************XXXX******X******XX***XXXXX***XXXXX******XX***XXXXX***XXXXX******XX***XXXXX***XXXXX******XX***XXXXX***XXX
*****XX****X********XXXX*****XX****X********XXXX*****XX****X********XXXX*****XX****X********XXXX*****XXXXXX****XX***XXXX*****XXXXXX****XX***XXXX*****XXXXXX****XX***XXXX*****XXXXXX****XX***XXXX
XX******XX***XXXXX***XXXXX******XX***XXXXX***XXXXX******XX***XXXXX***XXXXX******XX***XXXXX***XXXXX******XX***XXXXX***XXXXX******XX***XXXXX***XXXXX******XX***XXXXX***XXXXX******XX***XXXXX***XXX
XX***XXXX**XXXXX****XXXXXX***XXXX**XXXXX****XXXXXX***XXXX**XXXXX****XXXXXX***XXXX**XXXXX****XXXX*****XXXXXX****XX***XXXX*****XXXXXX****XX***XXXX*****XXXXXX****XX***XXXX*****XXXXXX****XX***XXXX
XX***XXXXXXXXXXXXXX****XXX***XXXXXXXXXXXXXX****XXX***XXXXXXXXXXXXXX****XXX***XXXXXXXXXXXXXX****X*****XXXXXX****XX***XXXX*****XXXXXX****XX***XXXX*****XXXXXX****XX***XXXX*****XXXXXX****XX***XXXX
*****XXXXXX****XX***XXXX*****XXXXXX****XX***XXXX*****XXXXXX****XX***XXX******XXXXXX*********XXXXXX******XX***XXXXX***XXXXX******XX***XXXXX***XXXXX******XX***XXXXX***XXXXX******XX***XXXXX***XXX
X***********************XX*************XXXX*****XX*************XXXX*****XX*************XXXX*****XX******XX***XXXXX***XXXXX******XX***XXXXX***XXXXX******XX***XXXXX***XXXXX******XX***XXXXX******